b,b,b,b,b,b,b,b,b,b,b,b,b,b,b,b,b,b
b, , , , , , , , , , , , , , , , ,b
b, , , , , , , , , , , , , , , , ,b
b, , , , , , , , , , , , , , , , ,b
b, , , , , , , , , , , , , , , , ,b
b, , , , , , , , , , , , , , , , ,b
b, , , , , , , , , , ,b, , , , , ,b
b, , , , , , , , , , ,b, , , , , ,b
b,s, , , ,b, , , , , ,b, , , , ,e,b
b,b,b,b,b,b,b,b,b,b,b,b,b,b,b,b,b,b
b,b,b,b,b,b,b,b,b,b,b,b,b,b,b,b,b,b